I_initial,I_final,Energy_E2,Energy_M1,Level_energy,norm_population
16,14,312,0,2928,0.001     
15,13,348,179,2616,0.001
14,12,169,326,2268,0.001
13,11,157,0,2099,0.001
12,10,145,0,1942,0.001
11,9,133,0,1797,0.001
10,8,482,605,1664,0.001   
10,8,123,0,1182,0.001     
9,8,111,0,1059,0.001
8,8,0,0,948,0.001